222222222222222222222210000000000000000000000
222222222222222222222210000000000000000000000
222222222222222222222211000000000000000000000
222222222222222222222211000000000000000000000
222222222222222222222211000000000000000000000
222222222222222222222211000000000000000000000
222222222222222222222221000000000000000000000
222222222222222222222221000000000000000000000
222222222222222222222221000000000000000000000
222222222222222222222211000000000000000000000
222222222222222222222211000000000000000000000
122222222222222222222211000000000000000000000
112222222222222222222211000000000000000000000
011222222222222222222210000000000000000000000
001122222222222222222110000000000000000000000
000112222222222222222110000000000000000000000
000011222222222222222110000000000000000000000
000001122222222222221100000000000000000000000
000000111222222222211100000000000000000000000
000000011122222222111000000000000000000000000
000000001111222221111000000000000000000000000
000000000111111111110000000000000000000000000
000000000001111111100000000000000000000000000
000000000000000000000000000000000000000000000
000000000000000000000000000000000000000000000
