00000000000000000000000222000000000000000002220000000000000000022200000000000000000002220000000000000000000000000002220000000000000000000000000222000000000000000000000000000222000000000000000002220000
00000000000000000000000111000000000000000001210000000000000000022210000000000000000012220000000000000000000000000012220000000000000000000000000121000000000000000000000000000222100000000000000001110000
00000000000000000000000110000000000000000001100000000000000000022221000000000000000122210000000000000000000000000122210000000000000000000000000110000000000000000000000000000222210000000000000001100000
00000000000000000000000000000000000000000012100000000000000000012222221111100000000122210000000000000000000000001122210000000000000000000000001110000000000000000000000000000122222211000000000000000000
00000000000000000000000000000000000000000012200000000000000000002222222222211000000111100000000000000000000011111122100000000000000000000000001100000000000000000000000000000022222222200000000000000000
00000000000000000000000000000000000000000122200000000000000000001222222222221000000000000000000000000000000022211110000000000000000000000000012200000000000000000000000000000012222222210000000000000000
00000000000000000000000000000000000000001222210000000000000000000222222222220000000000000000000000000000000122211000000000000000000000000000122200000000000000000000000000000002222222220000000000000000
00000000000000000000000000000000000000001222210000000000000000000222222222220000000000000000000000000000000122210000000000000000000000000000122200000000000000000000000000000002222222220000000000000000
00000000000000000000000000000000000000012222220000000000000000000122222222210000000000000000000000000000000122100000000000000000000000000001222100000000000000000000000000000001222222220000000000000000
00000000000000000000000000000000000000112222221000000000000000000022222222200000000000000000000000000000000121000000000000000000000000001111222100000000000000000000000000000000222222220000000000000000
00000000000000000000000000000000000000112222222000000000000000000012222222100000000000000000000000000000000010000000000000000000000000122111221000000000000000000000000000000000122222210000000000000000
00000000000000000000000000000000000000011122222100000000000000000001222221000000000000000000000001000000000000000000000000000000000001222211110000000000000000000000000000000000012222100000000000000000
00000000000000000000000000000000000000000001222100000000000000000000000000000000000000000000000011000000000000000000000000000000000002222100000000000000000000000000000000000000000000000000000000000000
00000000000000000000000000000000000000000000222200000000000000000000000000000000000000000000000111000000000000000000000000000000000002221000000000000000000011000000000000000000000000000000000000000000
00000000000000000000000000000000000000000000122200000000000000000000000000000000000000000000000121000000000000000000000000000000000002221000000000000000000121000000000000000000000000000000000000000000
00000000000000000000000000000000000000000000012100000000000000000000000000000000000000000000001222000000000000000000000000000000000001210000000000000000001222000000000000000000000000000000000000000000
00000000000000000000000000000000000000000000001100000000000000000000000000000000000000000000012222100000000000000000000000000000000001100000000000000000012222000000000000000000000000000000000000000000
00000000000000000000000000000000000000000000000000000000000000000000000000000000000000011111222222100000000000000000000000000000000001100000000000001111222221000000000000000000000000000000111110000000
00000000000000000001111000000000000000000000000000000000000111000000000000000011111111222222222222200000000000000000000111000000000001100000000000012222222221000000000001111000000000000001222221000000
00000000000000000001222100000000000000000000000000000000001221100000000000000222211112222222222222210000000000000000001221000000000001100000000000122222222220000000000001222100000000000012222222100000
00000000000000000001222100000000000000000000000000000000002221000000000000001222211112222222222222220000001100000000002221000000000001110000000000222222222210000000000001222100000000000022222222200000
00000000000000000001222100000000000000000000000000000000012221000000000000012222210012222222222222221000011100000000012221000000000001210000000001222222222200000000000001222100000000000122222222210000
00000000000000000000122200000000000000000000000000000000012210000000000000122222100001222222222222222111222100000000012210000000000002221000000002222222222100000000000000122100000000000222222222220000
00000000000000000000012200000000000000000000000000000000022100000000000000222222000000122222222222222112222200000000012100000000000002222000000012222222222000000000000000012100000000001222222222221000
00000000000000000000012100000000000000000000000000000000012100000000000001222221000000022222222222222122222200000000001100000000000002222100000012222222221000000000000000011000000000002222222222221000
00000000000000000000001110000000000000000000000000000000111000000000000001222220000000001222222222111112222200000000000000000000000002222100000001222222210000000000000000000000000000012222222222210000
00000000000000000000001110000000000000000000000000000000111000000000000001222210000000000011111100000011222200000000000000000000000002222100000000001111000000000000000000000000000000012222111110000000
00000011000000000000000110000000000000000001100000000000110000000000000000222210000000000000000000000001222200000000000000000000000002222000000000000000000000000000000000000000000000022221000000000000
00000121000000000000000121000000000000000001210000000001210000000000000000122200000000000000000000000000122200000000000000000000000002221000000000000000000000000000000000000000000000022210000000000000
00001222000000000000000222100000000000000002221000000012220000000000000000012100000000000000000000000000012100000000000000000000000001210000000000000000000000000000000000000000000000012100000000000000
00002222000000000000000222210000000000000002221000000012220000000000000000001100000000000000000000000000001100000000000000000000000001100000000000000000000000000000000000000000000000011000000000000000
00012222100000000000000222221100000000000001222100000122210000000000000000000100000000000000000000000000001100000000000000000000000001000000000000000000000000000000000000000000000000000000000000000000
11122222100000000000000222222222100000000000122100000122100000000000000000000000000000000000000000000000001110000000000000000000000000000000000000000000000000222210000000000000000000000000000000000000
21222222210000000000000122222222210000000000011000000011000000000000000000000000000000000000000000000000000110000000000000000000000000000000000000000000000002222221000000000000000000000000000000000000
21122222210000000000000022222222220000000000000000000000000000000000000000000000000000000000000000000000000221000000000000000000000000000000000000000000000002222222100000000000000000000000000000000000
21112222221000000000000012222222220000000000000000000000000000000000000000000000000000000000000000000000000122100000000000000000000000000000000000000000000002222222200000000000000000000000000000000000
10000122222100000000000001222222220000000000000000000000000000000000000000000000000000000000000000000000000122210000000000000000000000000000000000000000000002222222220000000000000000000000000000000000
00000012222110000000000000222222220000000000000000000000000000000000000000000000000000000000000000000000000122210000000000000000000000000000000000000000000002222222221000000000000000000000000000000000
00000001222111110000000000022222220000000000000000000000000000000000000000000000000000000000000000000000000012211000000000000000000000000000000000000000000001222222222100000000000000000000000000000000
00000000111112222100000000002222210000000000000000000000000000000000000000000000000000000000000000000000000011110000000000000000000000000000000000000000000000222222222100000000000000000000000000000000
00000000000011222100000000000111100000000000000000000000000000000000000000000000000000000000000000000000000000000000000000000000000000000000000000000000000000011122222200000000000000000000000000000000
00000000000001222200000000000000000000000000000000000000000000000000000000000000000110000000000011000000000000000000000000000011000000000000000000110000000000000001222200000000000000000011000000000000
00000000000000122200000000000000000000000000000000000000000000000000000000000000000121000000000121000000000000000000000000000121000000000000000001210000000000000000122200000000000000000121000000000000
00000000000000012100000000000000000000000000000000000000000000000000000000000000000222000000000222000000000000000000000000000222000000000000000002220000000000000000012100000000000000000222000000000000
00000000000000011100000000000000000000000000000000000000000000000000000000000000000222100000001222000000000000000000000000001222000000000000000012220000000000000000011100000000000000001222000000000000
00000000000000000000000000000000000000000000000000000000000000000000000000000000000222210000012222000000000000000000000000112222000000000000000122220000000000000000001100000000000000012222000000000000
00000000000000000000000000000000000000122222222222222222111110000000001100000000000122210000012222000000000000000000001222222221000000000001111222220000000000000000000000000000000111112221000000000000
00000000000000000000000000000000000002222222222222222222222211100000111210000000000011100000012222000000000000000000012222222220000000000012112222220000000000000000000000000000001211112210000000000000
00000000000000000000000000000000000022222222222222222222222221100000112221000000000000000000012222000000000000000000022222222210000000000022222222220000000000000000000000000000012221111000000000000000
00000000000000000000000000000000000022222222222222222222222221000000012222100000000000000000001222000000000000000000022222222200000000000122211122220000000000000000000000000000122221000000000000000000
00000000000000000000000000000000000222222222222222222222222210000000001222220000000000000000000122000000000000000000022222222100000000000122110011210000000000000000000000000002222210000000000000000000
00000000000000000000000000000000000222222222222222222222222210000000001222222000000000000000000121000000000000000000022222222000000000000122100000110000000000000000000000000022222210000000000000000000
00000000000000000000000000000000001222222222222222222222222100000000000122222100000000000000000011000000000000000000022222222000000000000121000000000000000000000000000000000122222100000000000000000000
00000000000000000000000000000000002222222222222222222222222000000000000022222200000000000000000011000000000000000000012222220000000000000110000000000000000000000000000000000222222000000000000000000000
00000000000000000000000000000000012222222222222222222222221000000000000022222210000000000000000011000000000000000000001222100000000000001110000000000000000000000000000000001222222000000000000000000000
00011000000000000000000000000000022221100000000000001222221000000000000012222210000000000000000011000000000000000000000000000000000000001100000000000000000000000000000000001222221000000000000001100000
00011100000000000000000000000000022210000000000000000012220000000000000012222210000000000000000111000000000000000000000000000000000000011100000000000000000000000000000000001222221000000000000001110000
00012100000000000000000000000000022200000000000000000002220000000000000012222210000000000000000121000000000000000000000000000000000000012100000000000000000000000000000000001222221000000000000001210000
00022210000000000000000000000000012100000000000000000001210000000000000012222210000000000000001222000000000000000000000000000000000000122200000000000000000000000000000000001222221000000000000002221000
00022221000000000000000000000000011000000000000000000000110000000000000012222210000000000000012222000000000000000000000000000000000001222200000000000000000000000000000000001222221000000000000002222100
00122222211111111111110000000000011000000000000000000000000000000000000022222220000000000000122222000000000000000000000000000000000001222100000000000000000000000000000000001222221000000000000002222221
00122222222222222222222000000000011000000000000000000000000000000000000022222220000000001111122222000000000001110000000000000000000001111000000000001000000000000000000000001222221000000000000001222222
00122222222222222222222100000000011000000000000000000000000000000000000122222221000000012221222222000000000012211000000000000000000000000000000000011100000000000000000000001222221000000000000001222222
00122222222222222222222200000000012000000000000000000000000000000000000222222222000000122221122222000000000022210000000000000000000000000000000000012200000000000000000000001222221000000000000000122222
00122222222222222222222200000000022100000000000000000000000000000000001222222222100001222221111221000000000122210000000000000000000000000000000000012210000000000000000000001222221000000000000000022222
00122222222222222222222200000000122200000000000000000000000000000000012222222222211122222210000111000000000122100000000000000000000000000000000000012221000000000000000000001222221000000000000000002222
00122222222222222222222200000000122220000000000000000000000000000001112222222222211222222100000000000000000121000000000000000000000000000000000000012221000000000000000000001222221000000000000000001222
00122222222222222222222100000000122221000000000000000000000000001111112222222222212222222100000000000000000010000000000000000000000000000000000000002221000000000000000000001222221000000000000000000122
00122222222222222222221000000000122222000000000000000000000000012222111112222211111222221000000000000000000000000000000000000000000000000000000000001111000000000000000000001222221000000000000000000012
00022222110000000000000000000000122222000000000000000000000000022221000000000000000122221000000000000000000000000000000000000000000000000000000000000000000000000000000000001222221000000000000000000000
00022221000000000000000000000000122222100000000000000000000000022220000000000000000022220000000000000000000000000000000000000000000000000000000000000000000000000000000000001222221000000000000000000000
00022210000000000000000000000000122222100000000000000000000000022210000000000000000012220000000000000000000000000000000000000000000000000000000000000000000000000000000000001222221000000000000000000000
00012100000000000000000000000000122222100000000000000000000000012100000000000000000001210000000000000000000000000000000000000000000000000000000000000000000000000000000000001222221000000000000000000000
00011000000000000000000000000000122222100000000000000000000000011000000000000000000000110000000000000000000000000000000000000000000000000000000000000000000000000000000000001222221000000000000000000000
00000000000000000000000000000000222222100000000000000000000000000000000000000000000000110000000000000000000000000000000000000000001110000000000000000000000000000000000000001222221000000000000000000000
00000000000000000000000000000000222222000000000000000000000000000000000000000000000000010000000000000000000000000000000000000000122222211111111000000000000000111100000000000222220000000000000000000000
00000000000000000000000000000001222222000000000000000000000000000000000000000000000000000000000000110000000000000000000000000002222222221111222100000000000001222100000000000122210000000000000000000000
00000000000000000000000000000002222221000000000000000000000000000000000000000000000000000000000001210000000100000000000000000012222222221111222100000000000012222100000000000000000000000000000000000000
00000000000000000000000000000012222210000000000000000000000000000000000000000000000000000000000001221000011100000000000000000122222222221001222100000000000122222100000000000000000000000000000000000000
00000000000000000000000000000122222100000000000000000000000000000000000000000000000000000000000001222111122100000000000000000222222222210000122100000000000222221000000000000000000000000000000000000000
00000000000000000000000000000122221000000000000000000000000000000000000000000000000000000000000000222112222200000000000000001222222222100000012100000000001222220000000000000000000000000000000000000000
00000000000000000000000000000122210000000000000000000000000000000000000000121000000000000000000000122122222200000000000000012222222222000000011100000000002222210000000000000000000000000000000000000000
00000000000000000000000000000111100000000000000000000000000000000000000001222100000000000000000000011112222200000000000000012222222220000000001000000000022222200000000000000000000000000000000000000000
00000000000000000000000000000000000000000001000000000000000000000000000002222200000000000000000000000012222200000000000000022222211100000000000000000000022222200000000000000000000000010000000000000000
00000011000000000000000000000000000000000001100000000000110000000000000012222210000000000000000000000001222200000000000000022221000000000000000000000000122222100000000000000000000000011000000000000000
00000121000000000000000000000000000000000001210000000001210000000000000012222210000000000000000000000000122200000000000000022210000000000000000000000000122222100000000000000000000000012100000000000000
00001222000000000000000000000000000000000002221000000012220000000000000012222210000000000000000000000000012100000000000000012100000000000000000000000000122222100000000000000000000000022210000000000000
00001222000000000000000000000000000000000002222000000012220000000000000012222210000000000000000000000000011100000000000000011100000000000000000000000000122222100000000000000000000000022220000000000000
00012221000000000000000000000000000000000002222100000122220000000000000012222210000000000000000000000000001100000000000000011000000000000000000000000000122222100000000000000000000000022222000000000000
00012221000000000001100000000000000000000002222221111222210000000000000002222200000000000000000000000000000000000000000000111000000000000000000000000000022222100000000000000000000000122222211000000000
00001100000000000012210000000000000000000001222222211122100000000000000001222000000000000000000000000000000000000000000000110000000000000000000000000000012222100000000000000000000000122222222100000000
00000000000000000022210000000000000000000000222222211110000000000000000000110000000000000000000000000000000000000000000001220000000000000000000000000000002222100000000000000000000000122222222100000000
00000000000000000122210000000000000000000000122222210000000000000000000000000000000000000000000000000000000000000000000012220000000000000000000000000000001222100000000000000000000000122222222100000000
00000000000000000122100000000000000000000000012222100000000000000000000000000000000000000000000000000000000000000000000122220000000000000000000000000000000122000000000000000000000000122222221000000000
00000000000000000122100000000000000000000000002222100000000000000000000000000000000000000000000000000000000000000000001122210000000000000000000000000000000121000000000000000000000000122222221000000000
00000000000000000121000000000000000000000000001221000000000000001210000000000000000000000000001110000000000000000001111122210000000000000000000000000000000011000000000000000000000000122222210000000000
00000000000000001110000000000000011211000000000110000000000000022222000000000000000000000000022221000000000000000112221112100000000000000000000000000000000011000000000000000000000000122222200000000000
00000000000000001110000000000000012221000000000000000000000000122222100000000000000000000000122222000000000000000122211000000000000000000000000000000000000011000000000000000000000000122222200000000000
00000000000000001100000000000000012222000000000000000000000000122222100000000000000000000000122222100000000000000222210000000000000000000000000000000000000011000000000000000000000000122222100000000000
00000000000000012100000000000000001222000000000000000000000000122222100000000000000000000000122222100000000000000222100000000000000000000000000000000000000121000000000000000000000000122222100000000000
